
#+OPTIONS: toc:nil

#+BEGIN_EXPORT html
<script>
MathJax = {
  tex: {
    packages: {'[+]': ['base','ams','braket']},
    macros: {
      parentheses: ["\\left(#1\\right)", 1],
      crochets: ["\\left[#1\\right]", 1],
      accolades: ["\\left\\{#1\\right\\}", 1],
      ensemble: ["\\left\\{#1\\right\\}", 1],
      cardinal: ["\\mathop{\\mathrm{card}\\ }\\limits",0],
      identite: "\\mathrm{Id}",
      indicatrice: "\\boldsymbol{\\delta}",
      dirac: "\\delta",
      moinsun: "-1",
      inverse: "\\ddagger",
      pinverse: "\\dagger",
      topologie: "\\mathfrak{T}",
      ferme: "\\mathfrak{F}",
      img: "\\mathbf{i}",
      binome: ["\\left\\{ \\begin{array}{c} #1 \\\\ #2 \\\\ \\end{array} \\right\\}", 2],
      canonique: "\\mathfrak{c}",
      tenseuridentite: "\\boldsymbol{\\mathcal{I}}",
      permutation: "\\boldsymbol{\\epsilon}",
      matriceZero: "\\mathfrak{0}",
      matriceUn: "\\mathfrak{1}",
      christoffel: ["\\left\\{ \\begin{array}{c} #1 \\\\ #2 \\\\ \\end{array} \\right\\}", 2],
      lagrangien: "\\mathfrak{L}",
      sousens: "\\mathfrak{P}",
      partition: "\\mathrm{Partition}",
      tribu: "\\mathrm{Tribu}",
      topologies: "\\mathrm{Topo}",
      setB: "\\mathbb{B}",
      setN: "\\mathbb{N}",
      setZ: "\\mathbb{Z}",
      setQ: "\\mathbb{Q}",
      setR: "\\mathbb{R}",
      setC: "\\mathbb{C}",
      corps: "\\mathbb{K}",
      boule: "\\mathfrak{B}",
      intervalleouvert: ["\\left] #1 , #2 \\right[", 2],
      intervallesemiouvertgauche: ["\\left] #1 , #2 \\right]", 2],
      intervallesemiouvertdroite: ["\\left[ #1 , #2 \\right[", 2],
      fonction: "\\mathbb{F}",
      bijection: "\\mathrm{Bij}",
      polynome: "\\mathrm{Poly}",
      lineaire: "\\mathrm{Lin}",
      continue: "\\mathrm{Cont}",
      homeomorphisme: "\\mathrm{Hom}",
      etagee: "\\mathrm{Etagee}",
      lebesgue: "\\mathrm{Leb}",
      lipschitz: "\\mathrm{Lip}",
      suitek: "\\mathrm{Suite}",
      matrice: "\\mathbb{M}",
      krylov: "\\mathrm{Krylov}",
      tenseur: "\\mathbb{T}",
      essentiel: "\\mathfrak{E}",
      relation: "\\mathrm{Rel}",
      strictinferieur: "<",
      strictsuperieur: ">",
      ensinferieur: "\\eqslantless",
      enssuperieur: "\\eqslantgtr",
      esssuperieur: "\\gtrsim",
      essinferieur: "\\lesssim",
      essegal: "\\eqsim",
      union: "\\cup",
      intersection: "\\cap",
      opera: "\\divideontimes",
      autreaddition: "\\boxplus",
      autremultiplication: "\\circledast",
      commutateur: ["\\left[ #1 , #2 \\right]", 2],
      convolution: "\\circledcirc",
      correlation: "\\natural",
      diventiere: "\\div",
      modulo: "\\bmod",
      pgcd: ["\\mathop{\\mathrm{pgcd}\\ }\\limits",0],
      ppcm: ["\\mathop{\\mathrm{ppcm}\\ }\\limits",0],
      produitscalaire: ["\\left\\langle #1 \\vert #2 \\right\\rangle", 2],
      scalaire: ["\\left\\langle #1 \\| #2 \\right\\rangle", 2],
      braket: ["\\left\\langle #1 \\vert #2 \\vert #3 \\right\\rangle", 3],
      orthogonal: "\\bot",
      forme: ["\\left\\langle #1 , #2 \\right\\rangle", 2],
      biforme: ["\\left\\langle #1 , #2 , #3 \\right\\rangle", 3],
      contraction: ["\\left\\langle #1 \\odot #3 \\right\\rangle_{#2}", 3],
      dblecont: ["\\left\\langle #1 \\vert #3 \\vert #5 \\right\\rangle_{#2,#4}", 5],
      major: ["\\mathop{\\mathrm{major}\\ }\\limits",0],
      minor: ["\\mathop{\\mathrm{minor}\\ }\\limits",0],
      maxim: ["\\mathop{\\mathrm{maxim}\\ }\\limits",0],
      minim: ["\\mathop{\\mathrm{minim}\\ }\\limits",0],
      argument: ["\\mathop{\\mathrm{arg}\\ }\\limits",0],
      argmin: ["\\mathop{\\mathrm{arg\\,min}\\ }\\limits",0],
      argmax: ["\\mathop{\\mathrm{arg\\,max}\\ }\\limits",0],
      supessentiel: ["\\mathop{\\mathrm{ess\\,sup}\\ }\\limits",0],
      infessentiel: ["\\mathop{\\mathrm{ess\\,inf}\\ }\\limits",0],
      dual: "\\star",
      vardual: "\\circledast",
      distance: "\\mathfrak{dist}",
      norme: ["\\left\\lVert #1 \\right\\rVert", 1],
      normetrois: ["\\left|\\left\\| #1 \\right\\|\\right|", 1],
      adh: ["\\mathop{\\mathrm{adh}\\ }\\limits",0],
      interieur: ["\\mathop{\\mathrm{int}\\ }\\limits",0],
      frontiere: "\\partial",
      image: ["\\mathop{\\mathrm{im}\\ }\\limits",0],
      domaine: ["\\mathop{\\mathrm{dom}\\ }\\limits",0],
      noyau: ["\\mathop{\\mathrm{ker}\\ }\\limits",0],
      support: ["\\mathop{\\mathrm{supp}\\ }\\limits",0],
      signe: ["\\mathop{\\mathrm{sign}\\ }\\limits",0],
      abs: ["\\left\\lvert #1 \\right\\rvert", 1],
      unsur: ["\\frac{1}{#1}", 1],
      arrondisup: ["\\lceil #1 \\rceil", 1],
      arrondiinf: ["\\lfloor #1 \\rfloor", 1],
      conjugue: "conj",
      conjaccent: ["\\overline{#1}", 1],
      division: "division",
      difference: "\\boldsymbol{\\Delta}",
      differentielle: ["\\mathfrak{D}^{#1}_{#2}", 2],
      OD: ["\\frac{d #1}{d #2}", 2],
      OOD: ["\\frac{d^2 #1}{d #2^2}", 2],
      NOD: ["\\frac{d^{#3} #1}{d #2^{#3}}", 3],
      deriveepartielle: ["\\frac{\\partial #1}{\\partial #2}", 2],
      PD: ["\\frac{\\partial #1}{\\partial #2}", 2],
      dblederiveepartielle: ["\\frac{\\partial^2 #1}{\\partial #2 \\partial #2}", 2],
      dfdxdy: ["\\frac{\\partial^2 #1}{\\partial #2 \\partial #3}", 3],
      dfdxdx: ["\\frac{\\partial^2 #1}{\\partial #2^2}", 2],
      gradient: "\\mathbf{\\nabla}",
      combilin: ["\\mathrm{span}\\{ #1 \\", 1],
      trace: "tr",
      proba: "\\mathbb{P}",
      probaof: ["\\mathbb{P}\\left[#1\\right]", 1],
      esperof: ["\\mathbb{E}\\left[#1\\right]", 1],
      cov: ["\\mathrm{cov} ( #1 , #2 )", 2],
      var: ["\\mathrm{var} ( #1 )", 1],
      rand: "\\mathrm{rand}",
      variation: ["\\left\\langle #1 \\right\\rangle", 1],
      composante: ["\\mathop{\\mathrm{comp}\\ }\\limits",0],
      bloc: ["\\mathop{\\mathrm{bloc}\\ }\\limits",0],
      ligne: ["\\mathop{\\mathrm{ligne}\\ }\\limits",0],
      colonne: ["\\mathop{\\mathrm{colonne}\\ }\\limits",0],
      diagonale: ["\\mathop{\\mathrm{diag}\\ }\\limits",0],
      matelementaire: "\\mathrm{Elem}",
      matpermutation: ["\\mathop{\\mathrm{permut}\\ }\\limits",0],
      matunitaire: "\\mathrm{Unitaire}",
      gaussjordan: "\\mathrm{GaussJordan}",
      householder: "\\mathrm{Householder}",
      rang: "rang",
      schur: "\\mathrm{Schur}",
      singuliere: "\\mathrm{DVS}",
      convexe: "\\mathrm{Convexe}",
      petito: ["o(#1)", 1],
      grando: ["O(#1)", 1]
    }
  }
};
</script>
<script async src="https://cdn.jsdelivr.net/npm/mathjax@3/es5/tex-mml-chtml.js"></script>
#+END_EXPORT
